32
2 2 2 2 2 2 2 2 2 2 2 2 2 2 2 2 2 2 2 2 2 2 2 2 2 2 2 2 2 2
1 1 1 1 0 0 0 0 0 0 0 0 0 0 0 0 0 0 0 0 0 0 0 0 0 0 1 1 1 1
1 1 1 1 0 - - - - - - - - - - - - - - - - - - - - 0 1 1 1 1
1 1 1 1 0 - - - - - - - - - - - - - - - - - - - - 0 1 1 1 1
1 1 1 1 0 - - - - - - - - - - - - - - - - - - - - 0 1 1 1 1
1 1 1 1 0 - - - - - - - - - - - - - - - - - - - - 0 1 1 1 1
1 1 1 1 0 - - - - - - - - - - - - - - - - - - - - 0 1 1 1 1
1 1 1 1 0 - - - - - - - - - - - - - - - - - - - - 0 1 1 1 1
1 1 1 1 0 - - - - - P - - - - - - - - - - - - - - 0 1 1 1 1
1 1 1 1 0 - - - - 0 0 0 - - - - - - - - - - - - - 0 1 1 1 1
1 1 1 1 0 - - - - - - - - - - - - - - - - - - - - 0 1 1 1 1
1 1 1 1 0 - - - - - - - - - - - - - - - - - - - - 0 1 1 1 1
1 1 1 1 0 - - - - - - - - - - - - - - - - - - - - 0 1 1 1 1
1 1 1 1 0 - - - - - - - - - - - - - - - - - - - - 0 1 1 1 1
1 1 1 1 0 - - - - - - - - - - - - - - - - - - - - 0 1 1 1 1
1 1 1 1 0 - - - - - - - - - - - - - - - - - - - - 0 1 1 1 1
1 1 1 1 0 - - - - - - - - - - - - 0 0 0 - - - - - 0 1 1 1 1
1 1 1 1 0 - - - - - - - - - - - - - - - - - - - - 0 1 1 1 1
1 1 1 1 0 - - - - - - - - - - - - - - - - - - - - 0 1 1 1 1
1 1 1 1 0 - - - - - 0 0 0 - - - - - - - - - - - - 0 1 1 1 1
1 1 1 1 0 - - - - - - - - - - - - - - - - - - - - 0 1 1 1 1
1 1 1 1 0 - - - - - - - - - - - - - S - - - - - - 0 1 1 1 1
1 1 1 1 0 0 0 0 0 0 0 0 0 0 0 0 0 0 0 0 0 0 0 0 0 0 1 1 1 1
1 1 1 1 1 1 1 1 1 1 1 1 1 1 1 1 1 1 1 1 1 1 1 1 1 1 1 1 1 1