32
2 2 2 2 2 2 2 2 2 2 2 2 2 2 2 2 2 2 2 2 2 2 2 2 2 2 2 2 2 2
1 1 1 1 0 0 0 0 0 0 0 0 0 0 0 0 0 0 0 0 0 0 0 0 0 0 1 1 1 1
1 1 1 1 0 - - - - - - - - - - - - - - - - - - - - 0 1 1 1 1
1 1 1 1 0 - - - - - - - - - - - - - - - - - - - - 0 1 1 1 1
1 1 1 1 0 - - - - - - - - - - - - - - - - - - - - 0 1 1 1 1
1 1 1 1 0 - - - - - - - - - - - - - - - - - - - - 0 1 1 1 1
1 1 1 1 0 - - - - - - - - - - - - - - - - - - - - 0 1 1 1 1
1 1 1 1 0 - - - - - - - - - - - - - - - - - - - - 0 1 1 1 1
1 1 1 1 0 - - - - - 8 - - - - - - - - - - - - - - 0 1 1 1 1
1 1 1 1 0 - - - - 0 0 0 - - - - - - - - - - - - - 0 1 1 1 1
1 1 1 1 0 - - - - - - - - - - - - - - - - - - - - 0 1 1 1 1
1 1 1 1 0 - - - - - - - - - - - - - - - - - - - - 0 1 1 1 1
1 1 1 1 0 - - - - - - - - - - - - - - - - - - - - 0 1 1 1 1
1 1 1 1 0 - - - - - - - - - - - - - - - - - - - - 0 1 1 1 1
1 1 1 1 0 - - - - - - - - - - - - - - - - - - - - 0 1 1 1 1
1 1 1 1 0 - - - - - - - - - - - - - - - - - - - - 0 1 1 1 1
1 1 1 1 0 - - - - - - - - - - - - - - - - - - - - 0 1 1 1 1
1 1 1 1 0 - - - - - - - - - - - - - - - - - - - - 0 1 1 1 1
1 1 1 1 0 - - - - - - - - - - - - - - - - - - - - 0 1 1 1 1
1 1 1 1 0 - - - - - - - - - - - - - - - - - - - - 0 1 1 1 1
1 1 1 1 0 - - - - - - - - - - - - - - - - - - - - 0 1 1 1 1
1 1 1 1 0 - - - - - - - - - - - - - - - - - - - - 0 1 1 1 1
1 1 1 1 0 0 0 0 0 0 0 0 0 0 0 0 0 0 0 0 0 0 0 0 0 0 1 1 1 1
1 1 1 1 1 1 1 1 1 1 1 1 1 1 1 1 1 1 1 1 1 1 1 1 1 1 1 1 1 1